1111111
10000P1
10001E1
10001C1
1111111