1111111111111111
110100C0000C0E01
10C00000000000H1
1101110000000101
100P10000CCCC0C1
1111111111111111