1111111111111111
110100C0000C0E01
10C0000000000101
1101110000000101
100P10000CCCC1C1
1111111111111111