1111111111111111111
1000C10100000000001
1P00000111100000001
1E00C00100000000001
1111111111111111111