111111111111
1E1C00000001
1000000000P1
111111111111