1111111111111
1010000000011
100P01111E001
1001110100001
1111111111111